ABY = "countries/Abyssinia.txt"
ADR = "countries/Adriatic_Empire.txt"
ALP = "countries/Alpland.txt"
ANG = "countries/Angevin_Empire.txt"
ARN = "countries/Greater_Armenia.txt"
ARR = "countries/Armenia_Republic.txt"
HBE = "countries/Austrian_Empire.txt"
AHE = "countries/Austro_Hungarian_Empire.txt"
BKL = "countries/Balkan_League.txt"
BTC = "countries/Baltic_Union.txt"
BSQ = "countries/Basque_Kingdom.txt"
BEL = "countries/Belgium.txt"
BNL = "countries/Benelux.txt"
KBS = "countries/Bosnia_Serbia.txt"
BVE = "countries/Bremen_Verden.txt"
BRM = "countries/Burma.txt"
CTG = "countries/Carthage.txt"
CAU = "countries/Caucasia.txt"
CEU = "countries/Celtic_Union.txt"
CHN = "countries/China.txt"
CIS = "countries/Cisalpina.txt"
CZE = "countries/Czechoslovakia.txt"
EPR = "countries/East_Prussia.txt"
ERO = "countries/Emilia_Romagna.txt"
EUR = "countries/European_Union.txt"
FIB = "countries/Franco_Iberian_Empire.txt"
FRC = "countries/Franconia.txt"
FRL = "countries/Frieslande.txt"
GEP = "countries/German_Empire.txt"
GKR = "countries/Goguryeo.txt"
HNS = "countries/Hanseatic_League.txt"
HEN = "countries/Hesse_Nassau.txt"
IBE = "countries/Iberian_Empire.txt"
ITE = "countries/Italian_Empire.txt"
IMA = "countries/Italian_Merchant_Alliance.txt"
JGE = "countries/Jagiellonian_Empire.txt"
LVE = "countries/Lombardy_Venetia.txt"
LSX = "countries/Lower_Saxony.txt"
LSE = "countries/Lusitanian_Empire.txt"
MAC = "countries/Macedon.txt"
MGH = "countries/Maghrebia.txt"
NGC = "countries/North_German_Confederation.txt"
NSE = "countries/North_Sea_Empire.txt"
PON = "countries/Pontos.txt"
RHE = "countries/Rhine_Confederation.txt"
ROP = "countries/Roman_Republic.txt"
SRB = "countries/Saudi_Arabia.txt"
SBG = "countries/Siebenbuergen.txt"
SOV = "countries/Soviet_Union.txt"
SWB = "countries/Swabia.txt"
SNO = "countries/Sweden_Norway.txt"
TAT = "countries/Tatarstan.txt"
HIM = "countries/Tibetan_Empire.txt"
TRR = "countries/Turkey.txt"
TSI = "countries/Two_Sicilies.txt"
UKI = "countries/United_Kingdom.txt"
YUG = "countries/Yugoslavia.txt"